a list of references in Slay the Spire (only the ones that affect localization)

CARDS
	J.A.X.: Refers to getting jacked, as in- to get buff.
	Necronomicurse: References theNecronomicon, a book from the Evil Dead series.
	Die Die Die: References what Reaper in Overwatch, says while utilizing Death Blossom.

EVENTS
	Transmogrifier: References a machine by Calvin in Calvin and Hobbes.
	The Library: Randomly references 1 of 3 novels: Worm (web serial), The Martian, and Wool.

ENEMIES
	Byrd: Bird
	Lagavulin: References Lagavulin, located in Islay, Scotland. A whisky with the same name is produced there.
	Snecko: It's Snake + Gecko.
	Gremlin Nob: References the Warhammer 40k Ork Nob.

RELICS
	Art of War: References the Art of War by Sun Tzu.
	Black Star: References a song by David Bowie.
	Blue Candle: References Blue Candle, an item from The Legend of Zelda.
	Calling Bell: References the Beckoning Bell from Bloodborne.
	Centennial Puzzle: References the Millenium Puzzle from Yu-gi-oh.
	Charon's Ashes: References Charon of Greek Mythology.
	Dead Branch: References the Dead Branch from Ragnarok Online.
	Du-Vu Doll: References Voodoo doll.
	Enchiridion: References the Enchirdion, specifically the one from Adventure Time.
	Golden Idol/Bloody Idol: References the Golden Idol from Spelunky.
	Gold-Plated Cables: Flavor text references plating cables with gold to improve them (hint: it doesn't).
	Happy Flower: References the Sunflower from Plants vs Zombies.
	Inserter: This is the Inserter device from Factorio! The image is a yellow Inserter.
	Lee's Waffle: References Lee, friend of the developer- he had a waffle machine at work.
	Necronomicon: References the Necronomicon from Evil Dead.
	Nilry's Codex: References Codex. A tabletop game by Sirlin (Nilry is Sirlin backwards), a game designer.
	Paper Krane: This is an origami paper crane.
	Paper Phrog: This is an origami paper frog.
	Question Card: References the "? Card" from the Binding of Isaac.
	Shovel: Visually references the shovel used by Shovel Knight.
	The Specimen: Visually references Dorohedoro.
	Toxic Egg: Visually references Alien.